1111111111111111111
1E000000010001P0001
1000000101010110001
1111101100C100C1001
1000000111111111001
1000010001000C00001
10CC010001CC1000001
1011111001111000001
1000000000000000001
1111111111111111111
