111111111111111
1E00000001001P1
100000010101101
1111101100C00C1
100000011111111
100001000100C01
100000000000001
111111111111111
