11111111111
1P0000000E1
11110111101
10000000001
10111111001
10000001001
10111111001
10000000001
1000C0000C1
11111111111
