11111111111111
100010001000E1
1P100010C001E1
11111111111111
