1111111111111111111
10001000100010C01E1
1P100010C0100010001
1111111111111111111
