1111111111111111111
1P0001000C000000001
111100011111000C001
1000000100000000001
1001111101111111111
1000000100000000001
1111100100001111001
1000000111101000001
1001111100C01000C01
10000C0C00001000E01
1111111111111111111
