1111111111111111111
1P0001000C000000001
111100011111000C001
1000000100000000001
1001111101111111111
1000000100000000001
1001111100C01000CE1
1111111111111111111
