1111111111111
1P00000000001
1011111111001
1000000000001
1111011111101
1000010000001
1011110111101
1000000000C01
1011111111101
10000000000E1
1111111111111
