1111111
1PE0C01
1EEP0E1
1111111
